111111111
11C00C111
10P000CE1
111111111