1111111111111
1000000000011
1111110011111
10001000E0101
10Y000C0P0001
1000111100E11
1111111111111