1111111111111111111111111111111111
1E00Y0Y00Y0Y000C00000C000C00000001
101001010010Y0001C100100Y000010101
1010010010101010001001000Y00010101
1P0000000C00C0000000C000C0000000C1
1111111111111111111111111111111111